encoding declaration	deklaracja kodowania
segmentation	segmentacja
Note:	Uwaga:
Language Pattern	Wzorzec języka
non-unique	powtarzający się	segment
template	wyświetlanie	Schablonenhafte Darstellung von Informationen mit Variablen
modification info	informacje o modyfikacji
glossary	glosariusz
project dir	katalog projektu	<FR> le répertoire du projet
Fatal error	błąd krytyczny	<FR> une erreur majeure
External command	polecenie zewnętrzne	<FR> une commande externe
Exit code	kod wyjścia	<FR> code de sortie
unique segment	segment niepowtarzający się	<FR> un segment unique
Orphan segment	segment osierocony	<FR> un segment orphelin
Clipboard	schowek	<FR> un presse-papier
<FR> les segments orphelins	segmenty osierocone	mat_staszak
folder hierarchy	struktura folderów
fichier traduit	plik docelowy
<FR> fichier source	plik źródłowy
<FR> fichier source	plik źródłowy
<FR> caractère d'échappement	znak ucieczki
<FR> système des préférences	system preferencji
